5 8 4676 639 6565 4761 4320 6676 6730 6754 
5 13 4676 4631 4265 2654 6643 4348 241 6715 6756 6778 6805 6831 2996 
5 5 2996 6812 6796 6779 6754 
5 9 2996 4018 5280 6886 4685 3978 6823 6803 101 
5 17 101 6776 593 1574 6720 6711 6721 1034 6636 6609 6597 6610 4346 6653 6673 1006 783 
5 5 101 6747 6718 3239 6648 
5 5 6609 6584 6558 1615 1308 
5 8 1308 6471 6457 285 3363 5218 1053 6451 
5 3 1053 6522 6497 
5 3 6522 4020 6595 
5 5 639 6543 4328 6531 6522 
5 4 4761 6603 1868 6595 
5 3 6648 6620 6595 
5 7 1308 6482 3793 1750 6465 5241 3066 
5 6 5241 6435 6428 652 6368 1088 
5 3 4348 6680 6676 
5 4 6756 6757 844 6754 
5 5 6676 6684 5193 4064 6648 
5 7 6648 6608 386 6578 2454 6601 6609 
5 7 1308 6504 6515 6523 1919 6541 6522 
5 11 6756 6772 4383 6755 1906 1582 2691 6737 6703 1114 6630 
5 10 4265 6535 5106 3752 4132 6593 155 3413 6596 6630 
5 4 4132 6642 4170 1906 
5 7 1088 6338 6302 4399 6223 4233 6182 
5 8 6182 6164 6141 6130 6109 1121 2418 6006 
5 10 6006 5982 1469 5936 1888 5881 5860 5819 4368 5800 
5 10 5819 5834 3984 5851 5870 5894 5905 924 1856 5943 
5 12 5943 5947 5963 3557 2487 3705 6046 6062 6075 3681 2243 6111 
5 5 6111 1016 6137 6170 6157 
5 12 783 6586 6536 6506 6527 590 3403 6398 6413 6440 2612 6446 
5 9 6446 6452 306 6433 6409 2588 6383 6357 3416 
5 7 3416 2317 6263 3564 6195 6175 6157 
3 6 6182 6216 1276 2427 4701 6398 
3 7 4615 6095 1556 4014 6133 6113 6157 
3 14 4615 2586 4448 4957 2329 692 5940 5952 3755 5968 4995 6005 5093 6000 
3 10 6000 3236 3469 1827 1472 2153 5960 1754 3011 3318 
3 7 3318 5964 2755 5965 2263 187 3141 
3 8 3141 2297 3395 6007 4196 6040 4726 3637 
4 5 6175 6193 2766 3567 6224 
4 10 6224 6217 885 3440 922 6293 257 3161 5214 6489 
4 16 6489 2392 6622 868 6792 6821 6829 3196 3609 110 6815 272 2983 653 6750 2171 
4 9 2171 4075 1050 4647 2397 6978 7011 5100 6963 
4 16 7011 4514 3280 4531 261 7153 1767 7225 7245 7262 7287 361 7346 2935 379 7411 
4 17 7411 7421 7436 7481 7517 3517 538 4746 7585 7603 2017 3433 7629 3074 7621 4759 7649 
4 5 4647 4443 6951 2579 6963 
4 11 7411 4873 3144 4782 7519 7537 7566 7583 640 7610 4759 
4 23 7649 3918 7692 7710 4078 2394 3808 2857 7862 764 7904 7908 7919 7947 2340 3465 2132 8125 4400 8189 8199 8206 4191 
4 9 4191 8253 8248 4389 8299 8282 8273 8252 1931 
4 14 8189 8202 4430 1931 8234 8241 810 8233 8231 5040 8173 1522 8216 2680 
4 7 2680 760 4319 2328 5247 5039 8448 
4 12 8448 1646 8523 3454 5173 8540 2888 103 8539 5145 8522 8507 
4 9 8448 5290 8432 2476 3804 5058 656 8481 8507 
4 7 8507 3513 3204 4548 8515 4144 3191 
4 9 8522 8534 8557 8569 616 4380 8604 8616 8621 
4 7 3191 4583 8601 4717 2684 1661 8605 
4 10 8621 8629 3417 8667 8665 8657 3896 4879 5151 2684 
4 5 8605 3592 3016 8520 378 
4 22 8092 8104 4056 8123 4360 2576 3429 4219 8383 3449 3183 1515 2734 1588 2688 2057 4688 8477 1379 4324 1355 378 
4 16 378 4177 1946 8610 989 8653 4819 4247 8718 8720 669 3754 4454 8726 8732 8743 
3 17 4247 8710 8697 4449 4834 2302 8728 5084 8721 8706 8680 881 2941 5141 644 2133 2688 
4 14 2627 39 3145 4953 2549 7899 7923 4752 7957 2016 2231 8071 8086 8092 
4 14 2627 3830 7748 7697 7700 7679 795 7666 120 7600 1473 7575 7556 2464 
4 2 2464 5265 
5 11 5265 7520 7503 7489 5088 7490 1536 829 7447 5212 4733 
4 12 2464 7539 7529 7530 2370 3842 5169 7511 4363 7479 7461 4733 
5 8 4733 3159 7379 3822 425 7341 7324 7309 
5 16 7309 7295 7253 40 7166 7119 3915 7063 7041 7033 7013 2503 6928 6905 3195 2996 
5 18 6772 4396 1023 2539 5266 2029 6822 80 6830 6853 1560 3965 5240 6920 4152 1674 6998 6997 
5 14 6997 887 1092 7062 4671 1967 74 1989 673 2750 7137 7164 7129 7116 
4 9 6596 6530 5123 6462 1541 6376 555 6330 6340 
3 6 6340 449 3554 2786 6443 5106 
4 9 7033 3877 734 7042 7022 6981 6999 7004 2665 
3 12 7309 7290 5221 2203 7296 7275 7301 2995 7269 4517 3169 4224 
4 15 6803 6820 6834 4508 6887 1295 2665 7023 7058 4274 7078 7120 4738 7236 4224 
4 27 593 6788 6780 114 4185 6836 6862 6921 6942 1752 4710 7036 154 2717 1236 7121 1891 2829 7217 7231 2314 7261 2377 2280 7316 2189 7364 
4 22 6527 4778 6573 3660 6614 1814 1496 3070 6663 6688 4118 3137 6789 1410 2180 6859 3055 3736 5178 788 3768 4655 
3 23 6721 6744 3936 6769 2687 3704 1072 6863 3102 258 368 5067 1111 6925 619 6974 3743 6993 5250 3509 2967 7081 4655 
3 16 4274 2628 1571 1752 6955 2940 5156 435 1072 3578 6814 3237 4989 4455 6668 6663 
3 8 1891 7000 4986 368 1190 6838 1116 6789 
3 9 4655 635 1336 4298 1256 4184 7364 1501 7435 
3 9 6663 2547 2194 4799 41 591 1275 2909 3416 
3 5 2547 3845 2724 6473 6452 
4 11 4224 7281 7305 7329 7342 7403 482 3843 7500 7523 3834 
4 12 3834 1992 7577 5205 4956 3010 2318 7660 759 3724 7601 7599 
4 13 7599 4150 2527 481 895 4250 5206 3187 4120 7606 2018 3492 7575 
3 12 1992 3224 530 5023 863 7608 4539 1747 2485 15 595 4704 
3 11 3834 7541 7551 3478 3428 3301 7506 7480 3438 3013 7461 
3 13 7849 5028 7833 3150 4370 7812 7811 1897 1789 664 2249 1467 4120 
3 11 7811 4141 3703 3796 1167 351 7832 1804 7821 7810 39 
2 17 7849 727 4089 2837 7750 7715 3213 7667 1735 7599 5275 7593 2265 2902 742 7559 3478 
3 8 5240 1470 4723 3672 6707 6679 6651 5083 
4 14 6576 6562 205 2507 6546 4906 5260 4736 6560 6577 6588 5046 5083 6630 
4 21 6576 6599 5238 1547 6567 6575 3653 3674 1377 6450 6418 344 6328 6283 1836 2490 1188 6188 1225 6166 6178 
4 12 6166 2936 663 3773 5268 4487 5989 4820 923 4684 5911 4497 
4 15 5911 4918 5867 221 1798 5790 1177 4146 1036 4916 5643 5649 5619 4952 5593 
4 9 4952 4993 5587 1926 5578 5568 5557 5089 13 
4 11 6576 6553 6521 6491 2917 4295 3186 6396 6369 6337 6359 
3 6 4906 6496 6461 4762 3467 6359 
4 13 13 4962 3482 5553 5569 4938 5563 4928 5572 5584 5594 5606 5617 
4 7 4962 5520 5510 5506 5480 5462 5456 
4 14 4928 3881 5507 5504 5500 5496 1446 3749 1721 5444 5434 5073 5425 4044 
4 3 3747 5427 5073 
3 13 3747 5446 1290 5119 3666 157 3207 5519 5526 5552 3783 4507 2823 
3 6 2823 5614 5586 3814 5602 5617 
3 9 2823 5625 1042 5670 5714 2396 5189 5806 4138 
4 8 5617 2096 4811 3989 5687 4375 3646 4138 
3 14 1177 5771 3072 5694 1612 3840 5674 5661 5637 2671 5610 5224 1055 5617 
3 12 5519 4412 2186 5 5504 5488 5472 2951 4725 5228 3294 5462 
2 8 5674 5688 5703 790 5719 3656 5778 4138 
3 29 4497 5906 5880 1679 5864 5836 4100 5857 148 1412 3635 3837 5768 5724 5699 674 1583 5678 5667 5662 491 5638 2943 5634 4557 5620 3174 5611 5593 
3 2 3635 5116 
3 8 6328 2664 2020 1638 6316 373 6221 4481 
3 8 6369 1685 6349 6320 6298 2441 6228 4481 
3 10 5268 1869 4301 2460 5978 4047 6016 434 6050 6042 
2 13 4481 6189 3328 1498 3895 5998 5202 1218 4742 3057 6105 1997 346 
2 6 6042 3275 6082 6061 6039 3895 
2 27 591 6633 4781 6741 3383 6859 3055 6937 3743 6974 1138 2666 7157 7208 621 7231 3082 384 7297 376 7255 525 7306 1538 7260 1388 4224 
2 9 40 7184 7144 2745 7096 778 7126 7089 4274 
4 7 7041 4714 7016 6991 4228 3361 2539 
4 10 7041 7047 2858 7044 159 4905 7028 818 6969 5240 
2 9 6997 6953 2778 2557 4763 6699 6641 422 6560 
3 15 7116 4730 7084 7067 7043 4974 6958 6916 1549 5155 6828 2149 4837 2770 5238 
3 29 6178 6177 6194 6242 1652 6270 4361 4933 267 5018 6215 6197 6153 1303 6116 6085 4364 3227 6030 6010 4314 2727 987 5944 5926 5902 3546 5807 4138 
3 15 4684 533 2581 5997 5988 1523 4215 396 4770 6049 2643 5993 3263 5992 6010 
2 9 1523 5994 2560 5246 4159 5914 5232 1172 5902 
2 4 6194 3441 6078 4770 
3 5 6673 6696 6722 6740 3578 
4 11 3066 6385 2032 2442 6362 4217 6331 873 6411 1273 5218 
4 13 6331 725 6251 44 6174 6150 6140 6112 6118 6136 3687 1655 6251 
4 13 6150 6134 6127 6135 6122 3079 6108 1033 6065 2975 516 6019 6006 
4 3 6109 6080 2975 
4 13 6118 6106 1728 580 6031 6032 3839 2445 6018 1805 3549 6093 6122 
4 16 6031 528 1867 70 5928 5946 5916 5898 3576 5848 5838 5135 3399 4066 2222 5791 
4 15 5791 4419 4582 4466 5749 5753 5738 5759 5763 5764 5781 5772 5756 5774 5800 
4 11 5781 5808 5825 5809 5833 4754 5859 5885 1507 5172 5819 
4 21 5870 3281 5842 5826 5813 3359 3671 5785 469 4286 5794 1837 3266 2754 5835 5854 4358 5843 5855 1892 5863 
3 10 6062 6047 1871 3708 4246 5938 5891 3798 5824 5785 
3 4 5943 744 5865 3798 
3 7 5943 4445 336 5888 5865 5852 5826 
3 15 5756 3565 5708 4147 5682 3078 4270 5609 5598 358 165 2998 5535 5525 5515 
3 20 5515 5063 4258 5487 5471 1384 1408 1041 5437 4936 5051 5432 5440 3668 5454 5473 3947 5482 5486 5213 
3 8 5629 5656 5676 5692 2258 5072 5758 5791 
3 26 5629 5623 2896 5608 2480 5664 2176 3948 4877 5627 5621 5612 1479 5575 2986 3698 5279 5539 5549 5544 2024 5530 191 5041 5490 5213 
3 8 5629 1786 3899 2672 1599 2900 5613 5609 
2 16 5749 4899 5701 5686 3244 5632 1599 4331 4327 2087 286 4477 4367 3411 5492 5486 
3 13 5894 2533 1469 5959 5942 3850 5887 5868 5850 5832 5818 5792 5763 
3 5 5887 5873 5859 2486 5800 
3 6 6293 3206 6284 2732 4907 6314 
3 5 4615 197 1499 499 3440 
2 16 5952 3734 2659 2890 5748 5709 3735 921 5291 2012 5723 2512 2036 5909 5922 5960 
2 22 3318 5245 189 2970 4775 6161 794 6241 6310 2848 6299 775 884 6393 5115 2930 893 3156 2244 5256 6500 6489 
2 15 2512 1064 4405 3571 575 5734 2590 1038 2079 5776 2305 894 1886 5934 2297 
3 26 7116 3534 2382 7083 51 7054 4943 6973 4642 4130 6827 2308 6693 6654 6626 6606 3813 1531 6442 6441 6448 1345 4240 6327 6291 6270 
3 18 7164 5289 7179 7155 5294 7163 2614 7183 7162 196 7178 3487 2253 3496 5160 7244 4721 7264 
3 32 196 7100 1115 7093 2322 1095 925 6972 6915 6866 6787 477 4432 4937 6625 2202 6519 651 3415 416 3504 6401 6375 6353 6334 1958 6286 6267 6254 6238 6214 3269 
3 4 6153 2450 578 6238 
3 27 4937 3336 3792 2583 6724 1480 6753 3655 6766 4417 815 2496 797 4280 4786 943 6475 6459 4460 6455 1416 6387 2574 6348 5152 6345 6352 
3 44 3655 4025 2466 6880 6907 6935 2520 6990 2843 7111 1181 7159 7211 312 5163 4252 7243 7199 5132 1779 4773 1155 7070 183 3543 3485 3171 7186 7113 4732 3240 6986 2495 6873 4300 6818 2963 4439 1319 6640 6590 6549 270 4460 
3 8 4280 6765 772 6883 552 1698 7037 7070 
3 9 4460 1253 2410 6380 6308 1123 6247 2859 3269 
3 9 3655 6713 907 1325 6476 152 6404 2431 6353 
3 20 1181 1705 7172 5134 7212 7226 7251 7263 506 4814 7347 774 4560 2599 696 7467 3832 7526 2230 7538 
3 10 7538 3685 7463 3437 1559 112 2004 7279 2873 4721 
3 26 4937 6605 3811 2227 6618 2207 3452 6639 6606 6587 2889 4981 3262 6627 6694 3620 6790 3460 6892 1549 1829 5195 3775 824 7046 1967 
4 28 7164 7191 7223 7235 3544 4817 959 7323 7340 7349 1257 7396 1360 7441 7450 7451 7440 7445 686 2429 7427 7423 4334 5149 1206 7493 7502 5265 
3 22 7164 7187 7194 7222 729 7289 3264 2652 7348 3780 3885 5292 2240 689 7458 1130 7482 4972 7543 1937 5150 3774 
3 29 6790 5257 1823 6891 5281 6973 7027 7071 196 4223 7247 7280 4403 830 1934 7348 7359 117 4472 7355 1668 1859 959 1010 5243 864 4599 7147 1967 
3 28 2230 7597 952 1554 7648 3774 2675 7615 7622 3278 7637 7641 7638 3993 7581 7547 1488 4816 7545 4501 7562 3959 1074 7532 7535 7540 7524 5265 
3 16 7450 5140 7483 7515 7534 1488 7547 2336 2257 7624 4263 776 1521 7764 4766 39 
4 17 4824 8004 7978 462 3961 1964 7898 7891 1552 7851 2814 2939 295 279 7818 1956 39 
3 12 3774 4764 7701 4323 4401 4264 5283 179 625 4488 7883 1552 
3 6 7641 7656 7674 1411 3927 4401 
3 6 4401 7763 1803 4485 3490 7851 
3 26 1964 2621 3147 2524 1054 46 4910 4585 7804 7789 2800 7788 7783 7771 2116 5154 3272 7706 7712 2964 7685 3756 3364 2140 7711 7714 
3 5 7804 7798 7788 2800 7771 
3 10 7706 4519 4825 7640 929 1986 4565 7485 7462 2599 
3 29 7978 1696 7993 8023 2013 8039 3382 8055 3020 8038 3547 1372 2827 1664 8037 4027 1580 7922 1404 7942 7939 3725 976 7907 7918 2561 4645 7901 7913 
2 21 7913 4609 7931 4795 7948 383 8046 8107 4243 1817 8185 8184 4988 3540 5029 1223 4622 8162 5021 4308 5203 
2 10 8184 1573 8278 8318 2220 1297 3913 8381 3255 8414 
2 22 1580 4700 4335 746 277 8111 8127 8143 2709 8293 901 581 8393 8430 3777 1274 837 8541 3593 820 4210 4277 
2 3 837 2367 8511 
2 8 581 1395 1389 5230 8408 8378 8359 3740 
2 14 7901 7889 7873 3739 4475 2862 1333 5011 2867 3448 7713 957 5015 7714 
3 10 4824 8024 3883 8078 2804 2880 8172 8181 8186 8210 
3 5 8023 8047 1005 8015 4824 
3 17 8004 4691 3970 8035 3349 8013 8009 8007 2987 327 8025 8016 8026 8005 8040 4260 1154 
3 3 8005 3274 7923 
3 24 8383 751 8367 631 2556 609 3529 3977 498 8513 8527 3322 8568 8563 8572 8596 2369 4579 8645 8660 1234 8712 3605 8711 
3 11 5084 2505 3958 1982 8687 3203 8683 225 8684 8705 2897 
3 14 2897 2205 2598 1461 8614 5223 3923 2144 3292 4067 2169 8491 8493 1588 
3 3 498 4747 2144 
3 5 8596 3201 8635 3902 2598 
3 16 8383 8370 8301 8313 3001 8337 713 8319 658 4495 8287 8286 3663 7 8397 2660 
3 9 378 8460 2660 527 55 5105 3299 8532 3191 
2 19 1804 7864 2752 7924 2016 3643 973 8010 3083 1233 8011 5010 8097 3080 1224 4749 8239 4015 8301 
2 9 2429 7408 3221 4034 7383 2509 708 5234 7489 
3 14 2429 7442 1511 4715 1074 4543 4692 995 795 2401 7717 3654 5236 3703 
3 7 895 7590 4456 2788 7518 3842 1536 
2 6 8286 3312 8198 3905 313 1987 
4 3 7044 7015 4228 
3 6 6853 1324 6881 1279 1624 7044 
3 19 8540 4547 909 4753 813 8673 2468 2167 8689 1999 3939 8678 3897 8692 5087 4079 8763 8775 8777 
3 5 8665 8679 8686 1944 5087 
2 9 2167 3353 999 8772 4530 3892 1294 8776 8777 
2 9 8448 1132 4494 238 5215 2781 8584 1765 1586 
3 14 8507 4355 5165 2219 8384 2440 8303 3968 3649 63 8079 3737 4924 7958 
3 7 8093 8094 3706 2474 993 4520 2440 
2 9 7958 7963 1703 85 8032 2042 8045 4422 8093 
2 10 8303 8333 4080 8376 5012 3904 8342 1100 8294 760 
4 8 4191 1051 8195 4437 8166 4035 2255 8164 
4 8 8166 4913 1830 8050 3068 7991 3320 7904 
3 12 8164 8183 8208 2426 8266 8279 8295 4442 8291 2000 1103 8248 
3 44 8164 1945 8154 1465 8218 1777 8251 8249 458 1635 5235 8289 8300 8321 8316 2326 2933 4304 8224 4640 8209 1587 4541 8177 8180 8235 4116 8280 8311 2797 8365 8366 8353 8343 4126 1699 4359 8379 5001 3717 988 8418 4521 8437 
2 6 8437 8451 8470 4469 8502 324 
2 24 8437 1478 3283 47 8443 1970 8478 3295 4537 8461 4181 2173 8464 3831 4157 8450 8433 842 3339 4610 8389 2236 444 8321 
2 7 3831 8429 107 5222 8304 2284 1587 
2 8 3831 4115 8405 8364 5288 3786 8357 8365 
3 11 8282 8351 3377 3527 123 2286 2531 8524 3181 8594 8603 
2 19 8233 3828 8277 2589 4297 8368 1216 3119 3527 8402 1427 8388 8361 8350 3769 4620 2851 8307 8266 
3 7 3939 3625 3021 8616 2918 4272 3191 
3 20 764 5082 761 7850 489 1561 4194 4322 387 7870 7881 720 1059 7920 7938 7943 735 3442 7964 4826 
3 14 3068 8062 8051 8072 3624 8056 573 3992 8036 1441 8006 3155 7960 7943 
3 34 735 7911 3990 4336 5079 7831 4365 7786 3432 1150 7705 7682 7677 5057 2242 7625 566 7572 2516 7542 7527 1283 201 7464 3694 7432 3231 130 4681 113 7292 2593 7271 4292 
3 10 7542 7533 4892 4894 7571 5198 852 7565 7561 538 
3 9 7649 721 7639 3888 4584 1347 7671 2573 309 
2 6 7566 385 7504 2832 741 7456 
3 4 379 7392 7385 130 
3 9 4365 4395 7836 5233 7782 3160 166 3844 3433 
3 7 4194 7803 2565 7741 7720 7704 7692 
2 5 2394 370 2121 7681 1347 
3 10 7967 7959 649 3515 2489 2472 1027 7890 7897 764 
3 6 7862 1619 3900 7865 7845 7834 
2 11 649 1489 574 1996 7834 1073 2558 2229 7734 322 2573 
2 8 7504 248 7438 3604 7415 7399 7405 7411 
3 10 3054 826 7174 7131 5032 1673 3316 3528 2764 7262 
4 24 3637 1113 520 1941 6207 3974 4354 6322 3398 4789 4828 6517 6532 6561 4595 427 3867 6816 3626 2298 6923 4463 6938 6963 
3 4 4443 6918 4245 2298 
3 38 3637 6102 4523 3690 5085 6230 6272 6305 2729 6394 6421 6474 6539 3498 2968 6670 768 3824 6786 2985 6857 2011 6888 5008 5271 4677 234 1700 7030 2898 7069 7109 7139 7169 7175 7197 2542 4292 
3 7 6963 3560 7029 7045 318 4153 7107 
3 4 7109 7107 7145 7169 
3 10 6923 6927 3369 6939 3723 6876 6906 3407 6919 4677 
2 12 6561 833 4238 1209 2063 6615 1366 1354 6705 3627 6698 768 
2 10 6532 601 496 3105 6490 3177 4954 6364 6372 6393 
2 15 3177 1136 6548 2294 1148 2171 1606 4891 6943 4299 1920 4183 58 2378 7245 
3 37 6249 6265 843 6285 6273 6306 6341 2782 948 4088 3569 6580 2502 2634 5286 3172 6872 6889 5025 586 613 3182 6985 1282 7018 7031 7048 2908 7105 2923 4239 7214 4528 505 7218 7213 2744 
3 13 7406 7386 7370 4902 2865 4823 7213 1254 7118 5002 7026 700 5008 
3 10 4088 1026 1686 6379 407 4005 1801 3451 4500 2729 
2 10 5286 511 6773 2102 3405 6616 4461 3710 1281 3498 
3 7 3398 4000 1516 6358 4587 3250 2729 
2 8 6888 6865 6839 4371 1437 1546 4238 6517 
2 13 2741 2123 1298 4528 7214 4239 2923 7080 1280 6924 3711 6911 6888 
2 12 775 5043 5248 6191 6152 6101 2277 3732 679 5983 5972 5960 
2 3 6000 6028 6081 
2 3 4615 6090 2307 
2 14 6489 4917 1396 6453 4921 2185 2618 6258 6224 6187 1174 6151 6133 2841 
2 8 7131 3505 7076 3744 1128 381 6856 6821 
2 16 4620 8419 1634 3378 455 213 2077 549 8529 5101 443 8504 542 2655 4156 4157 
2 4 8546 397 8497 8464 
2 5 1586 8553 606 8458 1216 
2 10 1586 3086 8622 750 8661 185 54 8599 8586 5173 
2 8 3927 4259 7760 1304 7756 7768 4593 4766 
2 6 2257 7624 1124 224 4606 795 
3 3 2621 3476 4488 
2 9 7851 7863 7869 3133 7894 28 1864 3163 7923 
2 4 8186 4187 1230 8025 
2 9 4786 6550 1632 1953 410 6326 6290 3766 3269 
2 14 3269 2869 1137 3178 6237 990 2971 624 6146 5014 6250 6287 6336 6352 
2 10 4770 3730 6117 1146 2212 6184 3118 6171 6154 6153 
2 13 4044 801 5419 5424 3823 5435 2950 3414 5441 5094 1952 1383 5456 
2 7 6997 1503 7073 5166 2195 2288 7028 
2 9 7044 5068 2807 2564 3235 3209 3679 5258 7295 
2 10 435 6949 7005 4549 7121 5121 7215 376 7351 2447 
2 10 7296 5148 1800 7096 7056 7022 7009 6933 1183 4018 
2 13 5598 333 2477 2714 1491 1003 3205 1585 3702 5114 1773 5725 469 
2 7 5800 5783 2372 5754 5743 4316 3205 
2 19 469 3360 2198 2040 5679 2938 5605 3638 4561 5565 919 5583 207 2477 3356 4929 5543 3650 5525 
2 13 5525 5513 620 71 878 1744 950 3474 4985 5429 180 5428 5051 
